***************************|###|****************************
*|-|*|-------------------|*|###|*|--------------------|*|-|*
*|#|*|-------------------|*|###|*|--------------------|*|#|*
*|#|***********************|###|************************|#|*
*|#---------|*|-------------###-------------|*|----------#|*
*|----------|*|-----------------------------|*|-----------|*
************************************************************
--------|*|--------------------------------------|*|--------
--------|*|--------------------------------------|*|--------
************************************************************
*|------|*|--|*|----------         ---------|*|--|*|------|*
*|######|*|##|*|              |             |*|##|*|######|*
*|######|*|##|*|              |             |*|##|*|######|*
*|######|*|##|*|              |             |*|##|*|######|*
*|######|*|##|*|----------------------------|*|##|*|######|*
*|######|*|##|********************************|##|*|######|*
*|######|*|##|*|--|*|-------------------|*|-|*|##|*|######|*
*|------|*|##|*|--|*|-------------------|*|-|*|##|*|------|*
**********|##|***************|#|**************|##|**********
---------*|--|*------------------------------*|--|*---------
************************************************************
*|---------|*||*|--------------------------|*||*|---------|*
*|#########|*||*|--------------------------|*||*|#########|*
*|---------|*****************||**************||*|---------|*
****************|--------------------------|****************
-----------*|-|*|-----------#####----------|*|-|*-----------
************|#|************|#####|***********|#|************
*|----------|#|----------|*|#####|*|---------|#|----------|*
*|-----------------------|*|-----|*|----------------------|*
************************************************************